20 10
WWWWWWWWWW
WOOFFOOFOW
WFFFOOOFOW
WGOFOFOFOW
WOFOOOOFOW
WFOOOFOOFW
WFFOOFOFOW
WWWWOWWOWW
WFFFOOOFFW
WOWWWWWWWW
WFFFFFFOOW
WOOOFFFOFW
WFOFFOOFFW
WOOOFOOFOW
WFOOFFFOFW
WWWWFOOOFW
WFFOOFFOOW
WOOOOOOOOW
WFFFFFFFFW
WWWWWWWWWW
J 4 2 % posição do jogador
P 6 3 8 7 % posição dos pedregulhos
D 2 3 3 6 17 3 % dois diamantes nas posições
I 3 5 18 5 % posição com inimigo imóvel